MANISWEW - maniswêw
MANIKKAHWEW - manikahwêw
MANISIKEWIN - manisikêwin
MANISIGAN - manisikan
MANIKWEYÂWESWEW - manikwayawêswêw
MANIPAYIW - manipayiw
MANISTIKWÂNESWEW - manistikwânêswêw
MANIWATEW - maniwatêw
MANESIW - manêsiw
MANESIWIN - manêsiwin
MÂNÂ - mâna
MÂNINAKISK - mâninakisk
MANITOWIW - manitôwiw
MANITOWAN - manitowan
KIKAMOW - kikamow
KIKAMOHEW - kikamohêw
KIKASÂKEW - kikasâkêw
KIKASÂMEW - kikasâmêw
KIKASKISINEW - kikaskisinêw
KIKITÂSEW - kikitâsêw
KIKASTISEW - kikastisêw
KIKASTOTINEW - kikastotinêw
KIKAYONISEW - kikayiwinisêw
KIKKÂNÂKUSIW - kîhkânâkosiw
KIKKÂNÂKWAN - kîhkânâkwan
KIKKÂNAWEW - kîhkânawêw
KIKKÂWITTAWEW - kîhkâwihtawêw
IYIKATETTEW - yîkatêhtêw
IYIKÂTENEW - yîkatênêw
IYIKÂTENAMÂWEW - yîkatênamawêw
IYIKITCHIKÂWIW - yîkicikâwîw
IYIPEYAW - yîpêyâw
IYIPESIN - yîpêsin
IYIPATTAW - iyipahtâw
IYAWIS - iyawis
PWÂWATEWIN - pwâwatêwin
PWÂTAWIHEW - pwâtawihêw
PWÂT - pwâta
PWÂTIWIW - pwâtiwiw
PWÂTIMOW - pwâtimow
PWÂTIMOWIN - pwâtimowin
PWÂSIMOW - pwâsîmow
PAYIPAHWEW - payipahwêw
SEKWÂMOW - sêkwâmow
SEMÂK - sêmâk
SEMÂKUTTEW - sêmâkohtêw 
SENIBÂN - sênipân
SENIBÂNASSABÂB - sênipânisapâp
SESKISIW - sêskisiw
SESKIPITEW - sêskipitêw
SESSEGAN - sîsîkan
MÂMÂTTAWI-TOTAM - mamâhtâwi-tôtam
MÂMÂTTAWI-IJITJIKEW - mamâhtâwisîhcikêw
MÂMÂTTAWIPAYIW - mamâhtâwipayiw
MÂMÂTTÂWEYIMEW- mamâhtâwêyimêw
MÂMITTEYIMEW - mamihtêyimêw
MÂMITTEYITTÂKUSIW - mamihtêyihtâkosiw
MÂMITTEYITTÂKUSIWIN - mamihtêyihtâkosiwin
MÂMÂTTÂWIHIWEWIN - mamâhtâwihiwêwin
MÂMÂTTÂWIHIKOWIN - mamâhtâwihikowin
MÂMÂTTÂWIHIKOWISIW - mamâhtâwihikowisiw
MÂMÂTTÂWIHIKOWISIWIN - mamâhtâwihikowisiwin
MÂMÂTTAWISIW - mamâhtâwisiw
MÂMÂTTAWISIWIN - mamâhtâwisiwin
MÂMÂTTAWAN - mamâhtâwan
MÂMITJIMEW - mamihcimêw
MÂMITJIMIKUSIW - mamihcimikosiw
MÂMITJIMOW - mamihcimow
MÂMITJIMISUW - mamihcimisow
MÂMITJIMOWIN - mamihcimowin
MÂMITJIMISUWIN - mamihcimisowin
MÂMITTISIW - mamihcisiw
MÂMITTISIWIN - mamihcisiwin
EMIKKWÂN - êmihkwân
ENS - êsa
ENSIS - êsisis
ENSKEW - êskêw
ESKAN - êskan
ESKWA - êskwa
ETCHIKA - êcika
AWASEWEW - awasêwêw
ÂWASUW - awasow
AWASUWIN - awasowin
AWATEW - âwatêw
AWATCHITÂBEW - âwacitâpêw
AWATOPEW - âwatôpêw
AWÂH - awa
AWÂSIS - awâsis
AWÂSISSIWIW - awâsisîwiw
AWÂSISSIWIWIN - awâsisîwiwin
AWÂSISIKKÂSUW - awâsisihkâsow
AWENA - awêna
KIJIK - kîsik
KITCHI-KIJIK - kihci-kîsik
KIJIKAW - kîsikâw
KIJIKANISIW - kîsikanisiw
KIJIKANISIWIN - kîsikanisiwin
KIJIKÂSTEW - kîsikâstêw
KISIPAKAW - kîsipakâw
KISIPATINAW - kisipatinâw
KISIPASKAMIK - kisipaskamik
KISIPASKAMIKAW - kisipaskamikâw
KISIPIGAMAW - kisipikamâw
KISIPISTIKWEYAW - kisipistikwêyâw
KISIPÂYIK - kisipâyihk
KISIPISIW - kisipisiw
KISIPAN - kisipan
KISIPAW - kisipâw
KISIPÂSKWEYAW - kisipâskwêyâw
KISISKWEWIW - kîsiskwêwiw
KIJITEPUW - kîsitêpow
KIJITEPUWIN - kîsitêpowin
